# CVS $Revision: $ $Author: $ -- Wed Jul 20 10:59:59 2011 -- reformated by prettylst.pl v1.39 (build 11455)
# Eidolon Evolution Bonus from Extra Evolution feat
# Class of the Master		Type			Bonus to Ability Pool
FOLLOWER:EidolonExtraEP=1	TYPE:Eidolon	BONUS:ABILITYPOOL|Eidolon Evolution|1
FOLLOWER:EidolonExtraEP=2	TYPE:Eidolon	BONUS:ABILITYPOOL|Eidolon Evolution|1
FOLLOWER:EidolonExtraEP=3	TYPE:Eidolon	BONUS:ABILITYPOOL|Eidolon Evolution|1
FOLLOWER:EidolonExtraEP=4	TYPE:Eidolon	BONUS:ABILITYPOOL|Eidolon Evolution|1
FOLLOWER:EidolonExtraEP=5	TYPE:Eidolon	BONUS:ABILITYPOOL|Eidolon Evolution|1
FOLLOWER:EidolonExtraEP=6	TYPE:Eidolon	BONUS:ABILITYPOOL|Eidolon Evolution|1
FOLLOWER:EidolonExtraEP=7	TYPE:Eidolon	BONUS:ABILITYPOOL|Eidolon Evolution|1
FOLLOWER:EidolonExtraEP=8	TYPE:Eidolon	BONUS:ABILITYPOOL|Eidolon Evolution|1
FOLLOWER:EidolonExtraEP=9	TYPE:Eidolon	BONUS:ABILITYPOOL|Eidolon Evolution|1

FOLLOWER:FamiliarEP=1	TYPE:Familiar	BONUS:ABILITYPOOL|Eidolon Evolution|1	DEFINE:MasterLevel|0	DEFINE:EidMaxAttacks|0	DEFINE:EidUsedAttacks|0	DEFINE:EidArms|0	DEFINE:EidArmsUsed|0	DEFINE:EidLegs|0	DEFINE:EidLegsUsed|0	BONUS:VAR|EidMaxAttacks|8
FOLLOWER:FamiliarEP=2	TYPE:Familiar	BONUS:ABILITYPOOL|Eidolon Evolution|1
FOLLOWER:FamiliarEP=3	TYPE:Familiar	BONUS:ABILITYPOOL|Eidolon Evolution|1
FOLLOWER:FamiliarEP=4	TYPE:Familiar	BONUS:ABILITYPOOL|Eidolon Evolution|1
FOLLOWER:FamiliarEP=5	TYPE:Familiar	BONUS:ABILITYPOOL|Eidolon Evolution|1
FOLLOWER:FamiliarEP=6	TYPE:Familiar	BONUS:ABILITYPOOL|Eidolon Evolution|1
FOLLOWER:FamiliarEP=7	TYPE:Familiar	BONUS:ABILITYPOOL|Eidolon Evolution|1
FOLLOWER:FamiliarEP=8	TYPE:Familiar	BONUS:ABILITYPOOL|Eidolon Evolution|1
FOLLOWER:FamiliarEP=9	TYPE:Familiar	BONUS:ABILITYPOOL|Eidolon Evolution|1
